6 10
##########
#@    %  #
# #### # #
# #   %# #
#&  ##  @#
##########
